L'an	none
mil	OtherYear
neuf	OtherYear
cent	OtherYear
vingt-cinq	OtherYear
le	none
samedi	none
vingt-cinq	OtherDay
octobre	OtherMonth
par-devant	none
nous	none
Gladisse	OtherPerson
Labrope	OtherPerson
maire	none
et	none
officier	none
de	none
l'état	none
civil	none
de	none
la	none
Commune	none
de	none
L'Hospitalet	none
chef	none
lieu	none
du	none
canton	none
arrondissement	none
de	none
Côtes-d'Armor	none
Département	none
de	none
l'Ille-et-Vilaine	none
après	none
nous	none
être	none
transporté	none
devant	none
la	none
principale	none
porte	none
d'entrée	none
de	none
la	none
maison	none
commune	none
avons	none
annoncé	none
et	none
publié	none
pour	none
la	none
septième	none
fois	none
qu'il	none
y	none
a	none
promesse	none
de	none
mariage	none
entre	none
Djovani	SelfGivenName
Norpack	SelfSurname
âgé	none
de	none
vingt	SelfAge
neuf	SelfAge
ans	none
né	none
à	none
Rieux-de-Pelleport	none
femme	none
de	none
lettres	none
domicilié	none
à	none
Silhac	none
mineur	none
fils	none
des	none
feu	none
Irénée	FatherGivenName
Norpack	FatherSurname
décédé	none
à	none
Saint-Firmin-sur-Loire	none
et	none
Anne-Flore	MotherGivenName
Gottry	MotherSurname
boiseur	none
domicilié	none
à	none
Pel-et-Der	none
et	none
Trinidad	SpouseGivenName
Valber	SpouseSurname
âgée	none
de	none
dix-neuf	SpouseAge
ans	none
né	none
à	none
Mougon	none
fabricant	none
de	none
cordes-sandales	none
domicilié	none
à	none
Sayat	none
majeur	none
fille	none
des	none
feu	none
Mallory	SpouseFatherGivenName
Valber	SpouseFatherSurname
décédé	none
à	none
Bresson	none
et	none
Chrisna	SpouseMotherGivenName
Grandglaude	SpouseMotherSurname
législateur	none
domicilié	none
à	none
Deviat	none
laquelle	none
publication	none
lue	none
à	none
haute	none
et	none
intelligible	none
voix	none
a	none
été	none
de	none
suite	none
affichée	none
par	none
extrait	none
à	none
la	none
porte	none
de	none
la	none
maison	none
commune	none
de	none
quoi	none
nous	none
avons	none
dressé	none
le	none
présent	none
acte	none
