L'an	none
mil	OtherYear
cent	OtherYear
trente	OtherYear
six	OtherYear
le	none
dimanche	none
vingt-cinq	OtherDay
février	OtherMonth
pardevant	none
nous	none
Lorye	OtherPerson
Foucart	OtherPerson
maire	none
et	none
officier	none
de	none
l'état	none
civil	none
de	none
la	none
Commune	none
de	none
Saint-Nicolas-de-la-Haie	none
chef	none
lieu	none
du	none
canton	none
arrondissement	none
de	none
Val-d'Oise	none
Département	none
du	none
Rhône	none
après	none
nous	none
être	none
transporté	none
devant	none
la	none
principale	none
porte	none
d'entrée	none
de	none
la	none
maison	none
commune	none
avons	none
annoncé	none
et	none
publié	none
pour	none
la	none
quatrième	none
fois	none
qu'il	none
y	none
a	none
promesse	none
de	none
mariage	none
entre	none
Jahrod	SelfGivenName
Thomagne	SelfSurname
âgé	none
de	none
cinquante-six	SelfAge
ans	none
chasseur	none
domicilié	none
à	none
Cuillé	none
né	none
à	none
Montaigu-de-Quercy	none
fils	none
des	none
conjoints	none
Bilaly	FatherGivenName
Thomagne	FatherSurname
blassonneur	none
et	none
Philippe	MotherGivenName
Blancette	MotherSurname
arabalétrier	none
les	none
deux	none
domicilié	none
en	none
cette	none
commune	none
et	none
demoiselle	SpousePrefix
Idaline	SpouseGivenName
Etiane	SpouseSurname
âgée	none
de	none
trente	SpouseAge
cinq	SpouseAge
ans	none
né	none
à	none
Saint-Martin-du-Bois	none
pharmacien	none
domicilié	none
à	none
Quissac	none
mineur	none
fille	none
des	none
époux	none
Chek	SpouseFatherGivenName
Etiane	SpouseFatherSurname
créateur	none
de	none
pots	none
et	none
Kimea	SpouseMotherGivenName
Prossé	SpouseMotherSurname
archevêque	none
les	none
deux	none
domicilié	none
à	none
Saint-Rémy-de-Provence	none
laquelle	none
publication	none
lue	none
à	none
haute	none
et	none
intelligible	none
voix	none
a	none
été	none
de	none
suite	none
affichée	none
par	none
extrait	none
à	none
la	none
porte	none
de	none
la	none
maison	none
commune	none
de	none
quoi	none
nous	none
avons	none
dressé	none
le	none
présent	none
acte	none
